111111111111111111111
100C10000000C00011PC1
10001C0C0000000011001
1000111C0000000000001
100000000000111000011
10001000000011100C011
10E0100000000C0000001
111111111111111111111
