1111111111111111111111
100C10000000C000110C11
10001C0C00000000110011
1000111C00000000000011
1000000000001110000111
1000100P000011100C0111
10E0100000000C00000011
1111111111111111111111
